pOnTimer=Java_Event_pOnTimer(PEnv,this,TObject(pasobj));
pOnBroadcastReceiver=Java_Event_pOnBroadcastReceiver(PEnv,this,TObject(pasobj),intent);
pAppOnCreate=Java_Event_pAppOnCreate(PEnv,this,context,layout);Connect.Init(gApp);
pAppOnScreenStyle=Java_Event_pAppOnScreenStyle(PEnv,this);
pAppOnNewIntent=Java_Event_pAppOnNewIntent(PEnv,this);
pAppOnDestroy=Java_Event_pAppOnDestroy(PEnv,this);
pAppOnPause=Java_Event_pAppOnPause(PEnv,this);
pAppOnRestart=Java_Event_pAppOnRestart(PEnv,this);
pAppOnResume=Java_Event_pAppOnResume(PEnv,this);
pAppOnStart=Java_Event_pAppOnStart(PEnv,this);
pAppOnStop=Java_Event_pAppOnStop(PEnv,this);
pAppOnBackPressed=Java_Event_pAppOnBackPressed(PEnv,this);
pAppOnRotate=Java_Event_pAppOnRotate(PEnv,this,rotate);
pAppOnConfigurationChanged=Java_Event_pAppOnConfigurationChanged(PEnv,this);
pAppOnActivityResult=Java_Event_pAppOnActivityResult(PEnv,this,requestCode,resultCode,data);
pAppOnCreateOptionsMenu=Java_Event_pAppOnCreateOptionsMenu(PEnv,this,menu);
pAppOnClickOptionMenuItem=Java_Event_pAppOnClickOptionMenuItem(PEnv,this,menuItem,itemID,itemCaption,checked);
pAppOnPrepareOptionsMenu=Java_Event_pAppOnPrepareOptionsMenu(PEnv,this,menu,menuSize);
pAppOnPrepareOptionsMenuItem=Java_Event_pAppOnPrepareOptionsMenuItem(PEnv,this,menu,menuItem,itemIndex);
pAppOnCreateContextMenu=Java_Event_pAppOnCreateContextMenu(PEnv,this,menu);
pAppOnClickContextMenuItem=Java_Event_pAppOnClickContextMenuItem(PEnv,this,menuItem,itemID,itemCaption,checked);
pOnDraw=Java_Event_pOnDraw(PEnv,this,TObject(pasobj),canvas);
pOnTouch=Java_Event_pOnTouch(PEnv,this,TObject(pasobj),act,cnt,x1,y1,x2,y2);
pOnClickGeneric=Java_Event_pOnClickGeneric(PEnv,this,TObject(pasobj),value);
pAppOnSpecialKeyDown=Java_Event_pAppOnSpecialKeyDown(PEnv,this,keyChar,keyCode,keyCodeString);
pOnClick=Java_Event_pOnClick(PEnv,this,TObject(pasobj),value);
pOnChange=Java_Event_pOnChange(PEnv,this,TObject(pasobj),txt,count);
pOnChanged=Java_Event_pOnChanged(PEnv,this,TObject(pasobj),txt,count);
pOnEnter=Java_Event_pOnEnter(PEnv,this,TObject(pasobj));
pOnClose=Java_Event_pOnClose(PEnv,this,TObject(pasobj));
pAppOnViewClick=Java_Event_pAppOnViewClick(PEnv,this,view,id);
pAppOnListItemClick=Java_Event_pAppOnListItemClick(PEnv,this,adapter,view,position,id);
pOnFlingGestureDetected=Java_Event_pOnFlingGestureDetected(PEnv,this,TObject(pasobj),direction);
pOnPinchZoomGestureDetected=Java_Event_pOnPinchZoomGestureDetected(PEnv,this,TObject(pasobj),scaleFactor,state);
pOnSeekBarProgressChanged=Java_Event_pOnSeekBarProgressChanged(PEnv,this,TObject(pasobj),progress,fromUser);
pOnSeekBarStartTrackingTouch=Java_Event_pOnSeekBarStartTrackingTouch(PEnv,this,TObject(pasobj),progress);
pOnSeekBarStopTrackingTouch=Java_Event_pOnSeekBarStopTrackingTouch(PEnv,this,TObject(pasobj),progress);
pOnTCPSocketClientMessageReceived=Java_Event_pOnTCPSocketClientMessageReceived(PEnv,this,TObject(pasobj),messagesReceived);
pOnTCPSocketClientConnected=Java_Event_pOnTCPSocketClientConnected(PEnv,this,TObject(pasobj));
pOnClickWidgetItem=Java_Event_pOnClickWidgetItem(PEnv,this,TObject(pasobj),position,checked);
pOnClickCaptionItem=Java_Event_pOnClickCaptionItem(PEnv,this,TObject(pasobj),position,caption);
pOnListViewLongClickCaptionItem=Java_Event_pOnListViewLongClickCaptionItem(PEnv,this,TObject(pasobj),position,caption);
pOnListViewDrawItemCaptionColor=Java_Event_pOnListViewDrawItemCaptionColor(PEnv,this,TObject(pasobj),position,caption);
pOnListViewDrawItemBitmap=Java_Event_pOnListViewDrawItemBitmap(PEnv,this,TObject(pasobj),position,caption);
pOnActionBarTabSelected=Java_Event_pOnActionBarTabSelected(PEnv,this,TObject(pasobj),view,title);
pOnActionBarTabUnSelected=Java_Event_pOnActionBarTabUnSelected(PEnv,this,TObject(pasobj),view,title);
